12 17 10000
***.*******.*****
*.......*........
****.............
**......**......*
*.......**....*.*
*...............*
*.......**....*.*
*...............*
*.......**.....$*
*****************
