5 9 1000
***.*****
*.......*
****.****
*$......*
*********
