10 9 10000
***.*****
*.......*
****...**
**......*
*.......*
*.......*
*.......*
*.......*
*......$*
*********
